amanda serrano	Highest Rank: 9
at&t stadium	Highest Rank: 19
blue jackets – canadiens	Highest Rank: 23
cedric the entertainer	Highest Rank: 15
crackstreams	Highest Rank: 5
david lynch	Highest Rank: 14
derby hat	Highest Rank: 11
dubbing	Highest Rank: 1
dubbing meaning	Highest Rank: 2
gator hat	Highest Rank: 12
jon jones vs stipe	Highest Rank: 8
karoline leavitt	Highest Rank: 3
katie taylor	Highest Rank: 8
larp	Highest Rank: 2
methstreams	Highest Rank: 5
oilers vs maple leafs	Highest Rank: 4
peter dinklage	Highest Rank: 10
rosie perez	Highest Rank: 1
snapback	Highest Rank: 7
streameast	Highest Rank: 12
ufc	Highest Rank: 5
ufc 309	Highest Rank: 7
ufc results	Highest Rank: 3
ufc tonight	Highest Rank: 6
who won the tyson paul fight	Highest Rank: 8
adam szalai	Highest Rank: 1
delay sports	Highest Rank: 13
delay sports bfc dynamo	Highest Rank: 14
deutschland bosnien	Highest Rank: 5
deutschland fußball	Highest Rank: 24
deutschland vs. bosnien-herzegowina	Highest Rank: 20
deutschland – bosnien-herzegowina	Highest Rank: 1
ein schritt zum abgrund	Highest Rank: 8
franziska brantner	Highest Rank: 17
eliane müller	Highest Rank: 24
france italie	Highest Rank: 4
italia francia	Highest Rank: 8
italie – france	Highest Rank: 2
italien – frankreich	Highest Rank: 7
jon jones	Highest Rank: 10
jon jones vs stipe miocic	Highest Rank: 16
циркон ракета	Highest Rank: 5
miss universo 2024	Highest Rank: 15
paul vs tyson	Highest Rank: 23
princesa yuriko	Highest Rank: 10
quien gano la pelea mike tyson y logan paul	Highest Rank: 2
ravens	Highest Rank: 7
steelers	Highest Rank: 8
steelers ravens	Highest Rank: 5
tyson	Highest Rank: 21
uruguay colombia	Highest Rank: 20
abhazia	Highest Rank: 13
andreea cuciuc	Highest Rank: 2
anglia irlanda	Highest Rank: 6
cinema city	Highest Rank: 20
germania bosnia-herțegovina	Highest Rank: 4
fussball deutschland bosnien	Highest Rank: 19
goodbye deutschland peggy und steff	Highest Rank: 10
handball bundesliga	Highest Rank: 22
hasenpest	Highest Rank: 12
konny reimanns	Highest Rank: 1
kristina ozturk	Highest Rank: 15
nations league deutschland	Highest Rank: 25
niederlande – ungarn	Highest Rank: 4
osnabrück bombenräumung	Highest Rank: 16
räumungsverkauf	Highest Rank: 11
tatort heute	Highest Rank: 6
teveo	Highest Rank: 21
türkei – wales	Highest Rank: 7
wer hat gewonnen mike tyson oder jake paul	Highest Rank: 9
wunderschön film	Highest Rank: 18
amazonas fc x goiás	Highest Rank: 5
athletico-pr x atlético-mg	Highest Rank: 1
atlético paranaense	Highest Rank: 22
brusque x guarani	Highest Rank: 10
chapecoense	Highest Rank: 17
chapecoense x coritiba	Highest Rank: 8
charles do bronx	Highest Rank: 14
crb	Highest Rank: 9
holanda x hungria	Highest Rank: 13
inglaterra x irlanda	Highest Rank: 15
itália x frança	Highest Rank: 19
janja	Highest Rank: 18
mike tyson vs jake paul quem ganhou	Highest Rank: 23
novorizontino x paysandu	Highest Rank: 4
o que é garganta de cheddar	Highest Rank: 7
paysandu	Highest Rank: 20
ponte preta	Highest Rank: 11
ponte preta x sport recife	Highest Rank: 3
quem ganhou a luta de mike tyson e jake paul	Highest Rank: 12
jaget finale	Highest Rank: 9
johann olav koss	Highest Rank: 14
kim wigaard	Highest Rank: 25
kristian ødegård	Highest Rank: 13
lilly sødal	Highest Rank: 19
maskorama	Highest Rank: 24
maskorama gjett	Highest Rank: 16
norge kasakhstan	Highest Rank: 23
norge mot kasakhstan	Highest Rank: 8
nrk maskorama	Highest Rank: 10
olav thon	Highest Rank: 1
olav thon barn	Highest Rank: 6
olav thon kone	Highest Rank: 17
pinakkel	Highest Rank: 3
sissel berdal haga thon	Highest Rank: 7
skøyteløper 1964	Highest Rank: 2
skøyteløper født 1964	Highest Rank: 5
søndagsåpen butikk	Highest Rank: 18
tiril eckhoff	Highest Rank: 4
tone damli	Highest Rank: 22
østerrike slovenia	Highest Rank: 15
gladiator 2	Highest Rank: 17
gladiatorul 2	Highest Rank: 19
half life 2	Highest Rank: 8
igor cuciuc	Highest Rank: 1
italia franța	Highest Rank: 9
liga natiunilor	Highest Rank: 23
mike tyson	Highest Rank: 15
muhammad ali	Highest Rank: 12
olanda ungaria	Highest Rank: 3
program pro tv	Highest Rank: 15
program tv	Highest Rank: 18
rezidentiat 2024	Highest Rank: 7
roblox	Highest Rank: 22
romania cipru	Highest Rank: 16
sf matei	Highest Rank: 11
szalai ádám	Highest Rank: 1
tari care nu recunosc kosovo	Highest Rank: 24
uefa	Highest Rank: 14
santos x crb	Highest Rank: 2
ufc hoje	Highest Rank: 16
vila nova x ituano	Highest Rank: 6
whindersson nunes	Highest Rank: 24
levi	Highest Rank: 10
levi finnland	Highest Rank: 6
migros aktionen	Highest Rank: 25
miss univers 2024	Highest Rank: 9
moto gp	Highest Rank: 15
motogp	Highest Rank: 11
neuseeland	Highest Rank: 12
nfl	Highest Rank: 23
sina	Highest Rank: 17
sinner	Highest Rank: 22
stipe miocic	Highest Rank: 20
webcam uetliberg	Highest Rank: 18
webcam zugerberg	Highest Rank: 21
apotheek van wacht	Highest Rank: 19
astrid de belgique	Highest Rank: 12
belgie israel	Highest Rank: 6
belgique israel	Highest Rank: 25
belgique israël	Highest Rank: 9
dag van de ambachten	Highest Rank: 16
de verhulstjes	Highest Rank: 22
dezondag.be/feest	Highest Rank: 5
dezondag/feest	Highest Rank: 7
israel vs belgium	Highest Rank: 9
israël belgië	Highest Rank: 1
israël – belgique	Highest Rank: 8
italië frankrijk	Highest Rank: 20
lotto uitslagen	Highest Rank: 24
maxim trio	Highest Rank: 3
nederland hongarije	Highest Rank: 2
patrick lagrou	Highest Rank: 4
who won jake paul vs mike tyson	Highest Rank: 18
alexander isak	Highest Rank: 19
allan edwall	Highest Rank: 12
allan svensson	Highest Rank: 1
ayari	Highest Rank: 10
druserna	Highest Rank: 3
epikondylit	Highest Rank: 2
estraden	Highest Rank: 5
gyökeres	Highest Rank: 20
idol	Highest Rank: 15
idol 2024	Highest Rank: 14
kerstin ljungström	Highest Rank: 23
maja ivarsson	Highest Rank: 8
miss universe 2024	Highest Rank: 2
nina gunke	Highest Rank: 11
snösmocka	Highest Rank: 13
sverige mot slovakien	Highest Rank: 4
sverige slovakien	Highest Rank: 7
tommy nilsson	Highest Rank: 6
vem vann mike tyson vs jake paul	Highest Rank: 9
viktor gyökeres	Highest Rank: 25
who won mike tyson vs jake paul	Highest Rank: 13
yasin ayari	Highest Rank: 16
abbas afridi	Highest Rank: 11
aus vs pak	Highest Rank: 8
australia vs pakistan	Highest Rank: 1
avrebo	Highest Rank: 16
chow wsobny	Highest Rank: 11
eurowizja junior 2024	Highest Rank: 10
flaga cypru	Highest Rank: 1
gingerbread nails	Highest Rank: 4
holandia – węgry	Highest Rank: 8
ksw	Highest Rank: 13
classera	Highest Rank: 22
globe soccer	Highest Rank: 11
italy vs france	Highest Rank: 12
new zealand vs sri lanka	Highest Rank: 2
uruguay vs colombia	Highest Rank: 9
إيطاليا ضد فرنسا	Highest Rank: 6
البلاك بورد	Highest Rank: 23
بلاك بورد	Highest Rank: 21
بلاك بورد التقنية	Highest Rank: 11
حلول	Highest Rank: 9
رايات	Highest Rank: 10
سورة الاعلى	Highest Rank: 18
عبير العلوان	Highest Rank: 1
كتبي	Highest Rank: 8
مدرستي	Highest Rank: 5
منصة	Highest Rank: 25
منصة مدرستي	Highest Rank: 4
منصة مدرستي تسجيل الدخول	Highest Rank: 16
منصتي	Highest Rank: 7
منصه	Highest Rank: 19
منصه مدرستي	Highest Rank: 3
نظام نور	Highest Rank: 20
نور	Highest Rank: 24
واجباتي	Highest Rank: 13
17 listopadu obchody	Highest Rank: 12
albánie – česko	Highest Rank: 3
czech republic freedom and democracy day	Highest Rank: 2
hartl	Highest Rank: 14
james hunt	Highest Rank: 25
jana paulova	Highest Rank: 13
jana paulová	Highest Rank: 5
karel vágner	Highest Rank: 6
koncert pro budoucnost	Highest Rank: 19
lucie vondráčková	Highest Rank: 10
marta dancingerová	Highest Rank: 8
máme co jsme chtěli	Highest Rank: 9
niki lauda	Highest Rank: 24
obchody 17.11	Highest Rank: 17
oskar hes	Highest Rank: 21
otevrene obchody 17.11	Highest Rank: 16
otevírací doba 17.11	Highest Rank: 18
patrik hartl	Highest Rank: 11
paulová	Highest Rank: 4
petr komínek	Highest Rank: 15
stardance 2024	Highest Rank: 23
uncharted	Highest Rank: 20
uncharted 2	Highest Rank: 22
český den boje za svobodu a demokracii	Highest Rank: 1
день борьбы за свободу и демократию в чехии	Highest Rank: 7
alemania bosnia y herzegovina	Highest Rank: 1
america vs bucaramanga	Highest Rank: 21
américa bucaramanga	Highest Rank: 4
cúcuta unión magdalena	Highest Rank: 5
daniela toloza	Highest Rank: 25
dónde mirar selección de fútbol de uruguay contra selección de fútbol de colombia	Highest Rank: 7
honduras méxico	Highest Rank: 6
inglaterra irlanda	Highest Rank: 8
ksw 100	Highest Rank: 15
ksw 100 karta walk	Highest Rank: 17
ksw 100 wyniki	Highest Rank: 9
kto wygral tyson czy paul	Highest Rank: 7
kwok	Highest Rank: 3
mamed khalidov	Highest Rank: 14
niedziela handlowa	Highest Rank: 16
niedziele handlowe 2024	Highest Rank: 23
niemcy – bośnia i hercegowina	Highest Rank: 2
rolnik szuka żony	Highest Rank: 22
sami swoi	Highest Rank: 25
szlachetna paczka	Highest Rank: 18
taniec z gwiazdami	Highest Rank: 5
vanessa aleksander	Highest Rank: 6
wisła kraków	Highest Rank: 24
włochy – francja	Highest Rank: 12
agen microstar88	Highest Rank: 4
bandar36 terkuat	Highest Rank: 11
belanda vs hongaria	Highest Rank: 2
gunawan dwi cahyo	Highest Rank: 10
hqtoto	Highest Rank: 18
inggris vs irlandia	Highest Rank: 8
italia vs prancis	Highest Rank: 15
jadwal motogp	Highest Rank: 16
jake paul	Highest Rank: 19
jerman vs bosnia dan herzegovina	Highest Rank: 3
konohatoto78 login	Highest Rank: 7
link gacor microstar88 mpo	Highest Rank: 1
link slot gacor mpopelangi	Highest Rank: 21
rajajago	Highest Rank: 5
situs gacor microstar88	Highest Rank: 24
situs slot gacor mpopelangi	Highest Rank: 20
slot 4d rajadewa138	Highest Rank: 6
slot gacor resmi microstar88	Highest Rank: 12
slot gacor trendi178	Highest Rank: 13
slot online gacor mpopelangi	Highest Rank: 23
sscasn	Highest Rank: 17
sscasn 2024	Highest Rank: 19
thailand vs laos	Highest Rank: 9
bookmyshow	Highest Rank: 20
coldplay ahmedabad	Highest Rank: 7
do sharks have bones?	Highest Rank: 4
e shikshakosh	Highest Rank: 15
filmyfly	Highest Rank: 25
hanuman chalisa	Highest Rank: 23
irfan khan	Highest Rank: 5
jake paul vs mike tyson	Highest Rank: 24
mike tyson vs jake paul who won	Highest Rank: 13
netherlands vs oman	Highest Rank: 6
portugal vs poland	Highest Rank: 17
rohit sharma	Highest Rank: 12
rrb	Highest Rank: 21
shala darpan	Highest Rank: 9
spencer johnson	Highest Rank: 2
sufiyan muqeem	Highest Rank: 3
tyson vs jake paul	Highest Rank: 22
udise plus	Highest Rank: 14
who won mike or jake	Highest Rank: 10
loteria boyaca	Highest Rank: 10
loteria de boyaca	Highest Rank: 12
loteria de boyaca hoy	Highest Rank: 9
loteria de medellin	Highest Rank: 17
loteria de santander	Highest Rank: 18
medellín atlético nacional	Highest Rank: 24
mike tyson vs jake paul en vivo	Highest Rank: 13
miss colombia 2024	Highest Rank: 22
países bajos hungría	Highest Rank: 6
perú chile	Highest Rank: 10
quien gano el miss universo 2024	Highest Rank: 9
quien gano la pelea de mike vs paul 2024	Highest Rank: 3
resultado loteria de boyaca	Highest Rank: 15
san lorenzo racing	Highest Rank: 1
allerta nebbia	Highest Rank: 4
bagnaia	Highest Rank: 12
ballando con le stelle	Highest Rank: 8
chi ha vinto tra tyson e jake paul	Highest Rank: 5
chi ha vinto tu si che vales 2024	Highest Rank: 2
federica nargi	Highest Rank: 20
finale atp torino	Highest Rank: 19
francia italia	Highest Rank: 10
fritz	Highest Rank: 22
jorge martin	Highest Rank: 11
luxottica festa di natale	Highest Rank: 13
manuel pia	Highest Rank: 1
motogp oggi	Highest Rank: 9
rabiot	Highest Rank: 6
serie c	Highest Rank: 25
sinner fritz	Highest Rank: 7
sinner ruud	Highest Rank: 17
tuttocampo	Highest Rank: 24
tv8	Highest Rank: 23
tv8 streaming	Highest Rank: 15
vincitore tu si que vales 2024	Highest Rank: 3
vladimir putin	Highest Rank: 21
ajax legends	Highest Rank: 11
ajax legends real madrid legends	Highest Rank: 9
ajax logo	Highest Rank: 8
anita meyer	Highest Rank: 5
burgemeester vianen	Highest Rank: 19
duitsland bosnië en herzegovina	Highest Rank: 2
engeland ierland	Highest Rank: 14
faith landman	Highest Rank: 12
junior songfestival 2024	Highest Rank: 7
mike tyson vs jake paul winner	Highest Rank: 18
netflix storing	Highest Rank: 4
ramses shaffy	Highest Rank: 10
stefan de walle	Highest Rank: 20
turkije wales	Highest Rank: 13
wie heeft gewonnen mike tyson of jake paul	Highest Rank: 6
wie is sinterklaas 2024	Highest Rank: 24
wie speelt sinterklaas	Highest Rank: 21
wout weghorst	Highest Rank: 22
zevenheuvelenloop	Highest Rank: 15
zevenheuvelenloop 2024	Highest Rank: 16
j1	Highest Rank: 23
jra	Highest Rank: 20
マイク タイソン	Highest Rank: 25
ユニクロ 感謝 祭	Highest Rank: 17
丸山 穂高	Highest Rank: 19
eurovision junior 2024	Highest Rank: 7
fpb	Highest Rank: 18
fpf	Highest Rank: 20
fpf resultados	Highest Rank: 12
itália frança	Highest Rank: 6
liga das nacoes	Highest Rank: 23
logan paul	Highest Rank: 14
mike tyson jake paul fight	Highest Rank: 22
mike tyson vs jake paul fight	Highest Rank: 15
milhão	Highest Rank: 21
moto rato	Highest Rank: 4
pedro guerra	Highest Rank: 1
pneumonia tabaco aquecido	Highest Rank: 2
quem ganhou mike tyson vs jake paul	Highest Rank: 5
serie b	Highest Rank: 13
totoloto	Highest Rank: 16
totoloto hoje	Highest Rank: 14
ventas	Highest Rank: 3
zerozero	Highest Rank: 17
anna munch	Highest Rank: 12
anna thygesen	Highest Rank: 25
anne laxholm	Highest Rank: 5
ella augusta	Highest Rank: 16
elsker dig for tiden	Highest Rank: 14
familier som vores	Highest Rank: 23
hvem vandt mike tyson eller jake paul	Highest Rank: 9
jutta leerdam	Highest Rank: 20
kjeld veirup	Highest Rank: 11
kjeld vejrup	Highest Rank: 4
krysantemum film	Highest Rank: 7
lottotal	Highest Rank: 15
miss universe	Highest Rank: 3
miss universe 2024 denmark	Highest Rank: 8
nikolaj coster-waldau	Highest Rank: 6
stjernenatten van gogh	Highest Rank: 10
victoria kjær theilvig	Highest Rank: 1
vild med dans	Highest Rank: 21
vild med dans 2024	Highest Rank: 22
兵庫 県 知事	Highest Rank: 14
兵庫 県 知事 選	Highest Rank: 16
兵庫 県 知事 選挙	Highest Rank: 12
兵庫 県 知事 選挙 出口 調査	Highest Rank: 4
兵庫 県 知事 選挙 情勢	Highest Rank: 22
兵庫 県 知事 選挙 投票 率	Highest Rank: 8
兵庫 県 知事 選挙 結果	Highest Rank: 2
兵庫 県 知事 選挙 速報	Highest Rank: 3
即 パット	Highest Rank: 13
地震 速報 大阪 震度	Highest Rank: 11
埼玉 栄	Highest Rank: 1
埼玉 栄 高校	Highest Rank: 5
小林 すすむ	Highest Rank: 6
斎藤 元彦	Highest Rank: 18
歌 心 りえ	Highest Rank: 10
海 に 眠る ダイヤモンド	Highest Rank: 24
清水 芽 々	Highest Rank: 7
磐田 対 横浜 fm	Highest Rank: 9
踊る 大 捜査 線	Highest Rank: 15
近く の ポップコーン に バター かけ て くれる 映画 館	Highest Rank: 21
bagyong pepito update	Highest Rank: 18
catanduanes	Highest Rank: 13
chelsea manalo	Highest Rank: 21
fisch codes	Highest Rank: 19
hornets vs bucks	Highest Rank: 6
iwanttfc	Highest Rank: 16
lotto result november 16 2024	Highest Rank: 5
miss universe 2024 coronation night	Highest Rank: 14
miss universe 2024 live	Highest Rank: 12
miss universe 2024 winner	Highest Rank: 8
pelicans vs lakers	Highest Rank: 2
pepito typhoon update	Highest Rank: 20
spurs vs lakers	Highest Rank: 7
sydney sweeney	Highest Rank: 15
tropical cyclone wind signal #1	Highest Rank: 25
tropical cyclone wind signal #2	Highest Rank: 1
tropical cyclone wind signal #3	Highest Rank: 4
tropical cyclone wind signal #4	Highest Rank: 10
warriors vs grizzlies	Highest Rank: 3
windy ph	Highest Rank: 23
andrei mangra	Highest Rank: 14
anglia–írország	Highest Rank: 7
dancing with the stars	Highest Rank: 8
dancing with the stars 2024	Highest Rank: 11
hatoslottó	Highest Rank: 21
hegyes berci	Highest Rank: 22
hollandia magyarország	Highest Rank: 12
hollandia–magyarország	Highest Rank: 2
m4 sport élő	Highest Rank: 18
m4 élő	Highest Rank: 20
magyar holland meccs	Highest Rank: 10
mihályfi luca	Highest Rank: 15
németország–bosznia-hercegovina	Highest Rank: 4
ablefast	Highest Rank: 22
blue film 2024 release date	Highest Rank: 25
chelsea vs man city	Highest Rank: 3
chidimma adetshina	Highest Rank: 15
england vs ireland	Highest Rank: 1
finland vs greece	Highest Rank: 24
germany vs bosnia and herzegovina	Highest Rank: 1
marsleisure	Highest Rank: 10
memefi okx airdrop	Highest Rank: 6
memefi okx claim	Highest Rank: 1
memefi pre market price	Highest Rank: 16
netherlands vs hungary	Highest Rank: 2
ondo state election	Highest Rank: 8
ondo state election 2024	Highest Rank: 4
pool result	Highest Rank: 11
real madrid vs barcelona	Highest Rank: 21
sweden vs slovakia	Highest Rank: 13
tottenham vs arsenal	Highest Rank: 9
turkey vs wales	Highest Rank: 14
amazing race suomi	Highest Rank: 24
arja koriseva	Highest Rank: 9
atte kilpinen	Highest Rank: 3
bess	Highest Rank: 18
eduard hallberg	Highest Rank: 12
elenia sähkökatkot	Highest Rank: 11
erja lyytinen	Highest Rank: 7
eu kieltää savuaromit	Highest Rank: 15
huone 301	Highest Rank: 21
isaac sene	Highest Rank: 17
lumisadevaroitus	Highest Rank: 8
masked singer	Highest Rank: 14
niki rauten	Highest Rank: 4
peter sarlin	Highest Rank: 10
samuli vasala	Highest Rank: 1
suomi – kreikka	Highest Rank: 13
sähkökatkokartta	Highest Rank: 6
thl varoittaa	Highest Rank: 2
tom packalen	Highest Rank: 19
tuulivaroitus	Highest Rank: 16
victoria kjaer	Highest Rank: 5
angst vor bananen	Highest Rank: 9
levi slalom	Highest Rank: 7
missy may	Highest Rank: 11
nicole beutler	Highest Rank: 18
romano schmid	Highest Rank: 22
ski alpin	Highest Rank: 21
slalom levi herren	Highest Rank: 6
thailand pilz	Highest Rank: 4
thailand pilz trichophyton	Highest Rank: 8
the little things	Highest Rank: 5
triangle of sadness	Highest Rank: 19
österreich gegen slowenien	Highest Rank: 20
österreich slowenien	Highest Rank: 10
österreich slowenien live	Highest Rank: 12
österreich vs slowenien	Highest Rank: 23
österreich – slowenien	Highest Rank: 1
betloto	Highest Rank: 2
enes ünal	Highest Rank: 19
galler	Highest Rank: 16
karadağ izlanda	Highest Rank: 8
olaszország–franciaország	Highest Rank: 6
szalai adam	Highest Rank: 3
szalay ádám	Highest Rank: 5
törőcsik franciska	Highest Rank: 25
whisperton	Highest Rank: 17
x faktor	Highest Rank: 19
x faktor 2024	Highest Rank: 23
xfaktor	Highest Rank: 24
ötöslottó	Highest Rank: 9
ötöslottó nyerőszámai	Highest Rank: 13
ötöslottó nyerőszámok	Highest Rank: 16
algérie – liberia	Highest Rank: 3
claude dubois	Highest Rank: 9
coupe de france	Highest Rank: 16
dave	Highest Rank: 18
diane tell	Highest Rank: 4
france all black	Highest Rank: 15
france nouvelle zelande	Highest Rank: 6
france nouvelle zelande rugby	Highest Rank: 12
indira ampiot	Highest Rank: 23
julian bugier	Highest Rank: 13
luc plamondon	Highest Rank: 1
miss univers 2025	Highest Rank: 19
prise d'otage	Highest Rank: 7
pupille	Highest Rank: 14
rugby	Highest Rank: 21
rugby france nouvelle zélande	Highest Rank: 10
sans filtre	Highest Rank: 11
titanic	Highest Rank: 22
di 동 코리아 수사	Highest Rank: 15
kgma	Highest Rank: 4
갓 성은	Highest Rank: 1
김수정	Highest Rank: 2
던담	Highest Rank: 16
동행 복권	Highest Rank: 17
디스 코드	Highest Rank: 20
로 블록 스	Highest Rank: 23
로또	Highest Rank: 13
마이크 타이슨	Highest Rank: 11
박지현	Highest Rank: 21
애니 24	Highest Rank: 24
애니 라이프	Highest Rank: 22
열혈 사제 2 다시 보기	Highest Rank: 18
이탈리아 대 프랑스	Highest Rank: 6
잉글랜드 대 아일랜드	Highest Rank: 3
정년 이	Highest Rank: 12
제이크 폴	Highest Rank: 10
존 존스	Highest Rank: 7
타이슨	Highest Rank: 8
타이슨 제이크 폴	Highest Rank: 9
타이슨 제이크 폴 경기	Highest Rank: 14
히든 페이스	Highest Rank: 19
week 20 pool fixtures 2024	Highest Rank: 23
week 20 pool result 2024	Highest Rank: 12
ane	Highest Rank: 24
mike tyson vs jake paul	Highest Rank: 17
mike tyson vs jake paul live	Highest Rank: 5
whatsapp web	Highest Rank: 21
ألمانيا ضد البوسنة والهرسك	Highest Rank: 1
المذيعة داليا فؤاد	Highest Rank: 7
بوابة التعليم الالكترونى	Highest Rank: 18
بيانات التلميذ	Highest Rank: 23
تصويت جلوب سوكر	Highest Rank: 12
جلوب سوكر	Highest Rank: 14
جلوب سوكر 2024	Highest Rank: 20
جورج ابراهيم عبدالله	Highest Rank: 4
matbet güncel giriş	Highest Rank: 11
mike tyson jake paul kim kazandı	Highest Rank: 15
mike tyson jake paul maçı kim kazandı	Highest Rank: 20
milli maç hangi kanalda	Highest Rank: 22
muazzez ilmiye çığ	Highest Rank: 5
tayfur havutçu	Highest Rank: 10
tumbet	Highest Rank: 13
turkiye galler	Highest Rank: 18
tv 8	Highest Rank: 25
tv 8 canlı	Highest Rank: 23
tv8 5 canlı	Highest Rank: 21
twitter tümbet	Highest Rank: 9
tümbet	Highest Rank: 7
tümbet giriş	Highest Rank: 4
tümbet güncel	Highest Rank: 1
tümbet güncel giriş	Highest Rank: 3
tümbet yeni giriş	Highest Rank: 6
داليا فؤاد	Highest Rank: 10
سعر الدولار اليوم مقابل الجنيه المصرى	Highest Rank: 13
شيري مجدي	Highest Rank: 6
مايك تايسون	Highest Rank: 8
مايك تايسون ضد جيك بول مباشر	Highest Rank: 3
مايك تايسون وجيك بول	Highest Rank: 9
واتس ويب	Highest Rank: 15
واتساب	Highest Rank: 25
واتساب ويب	Highest Rank: 16
وزارة التربية والتعليم	Highest Rank: 17
中 日 大戰	Highest Rank: 8
中 澳 大戰	Highest Rank: 9
中華 日本	Highest Rank: 14
中華 澳洲	Highest Rank: 2
勇士 對 灰 熊	Highest Rank: 4
古巴 日本	Highest Rank: 1
台 日 大戰	Highest Rank: 10
台灣 澳洲	Highest Rank: 7
吉 力 吉 撈	Highest Rank: 6
嶺 東 資訊	Highest Rank: 18
日本 古巴 比分	Highest Rank: 3
曾頌恩	Highest Rank: 20
林立	Highest Rank: 13
泰 森	Highest Rank: 21
泰 森 vs 保羅	Highest Rank: 23
泰 森 vs 保羅 線上 看	Highest Rank: 15
澳洲	Highest Rank: 19
石英	Highest Rank: 17
莊 昕 諺	Highest Rank: 25
萬 宜 颱風	Highest Rank: 16
藤井 風	Highest Rank: 22
郭俊麟	Highest Rank: 11
韓國 多 明 尼 加	Highest Rank: 5
高鐵 持 刀	Highest Rank: 12
黃蜂 對 公 鹿	Highest Rank: 24
türkiye galler	Highest Rank: 17
türkiye galler maçı	Highest Rank: 24
türkiye galler maçı hangi kanalda	Highest Rank: 12
türkiye maçı hangi kanalda	Highest Rank: 14
anh đấu với ireland	Highest Rank: 3
arcane 2	Highest Rank: 18
thapcamtv	Highest Rank: 25
thái lan đấu với lào	Highest Rank: 1
16 พฤศจิกายน 2567	Highest Rank: 6
ตรวจ 16 พฤศจิกายน 2567	Highest Rank: 2
ตรวจ ลอตเตอรี่	Highest Rank: 13
ตรวจ ลอตเตอรี่ 16 พฤศจิกายน 2567	Highest Rank: 10
ตรวจ สลาก	Highest Rank: 23
ตรวจ สลากกินแบ่ง รัฐบาล	Highest Rank: 16
ตรวจ สลากกินแบ่ง รัฐบาล 16 พฤศจิกายน 2567	Highest Rank: 14
ตรวจ หวย	Highest Rank: 21
ตรวจ หวย 16 11 67	Highest Rank: 11
ตรวจ หวย 16 พ ย 2567	Highest Rank: 12
almería deportivo	Highest Rank: 6
barça valencia	Highest Rank: 17
ben hur	Highest Rank: 25
cartagena s. d. huesca	Highest Rank: 16
dani benitez	Highest Rank: 9
eurovisión junior 2024	Highest Rank: 19
49ers	Highest Rank: 16
aviso de tormenta tropical	Highest Rank: 13
cruz azul vs tigres	Highest Rank: 4
cruz azul vs tigres amistoso	Highest Rank: 3
mike tyson vs jake paul quien gano	Highest Rank: 9
4d2u	Highest Rank: 25
4d88	Highest Rank: 11
chagee	Highest Rank: 13
chagee near me	Highest Rank: 4
check4d	Highest Rank: 12
damacai	Highest Rank: 16
leong jun hao	Highest Rank: 17
magnum 4d	Highest Rank: 8
magnum result	Highest Rank: 15
may calamawy gladiator	Highest Rank: 3
mkt result	Highest Rank: 19
2 de mayo olimpia	Highest Rank: 7
china suarez	Highest Rank: 5
deportivo madryn gimnasia y esgrima	Highest Rank: 8
nueva chicago	Highest Rank: 9
nueva chicago quilmes	Highest Rank: 3
paranaense atlético mineiro	Highest Rank: 2
pelea de tyson	Highest Rank: 25
peru vs chile	Highest Rank: 22
racing	Highest Rank: 21
san lorenzo	Highest Rank: 20
san lorenzo hoy	Highest Rank: 14
san martin de san juan	Highest Rank: 15
san martin de tucuman	Highest Rank: 23
tiktokio	Highest Rank: 23
tp.hcm đấu với cahn	Highest Rank: 5
trương mỹ lan vạn thịnh phát	Highest Rank: 8
xshcm	Highest Rank: 20
xsla	Highest Rank: 12
xstg	Highest Rank: 9
xổ số chủ nhật hàng tuần	Highest Rank: 4
xổ số khánh hòa	Highest Rank: 22
xổ số kiên giang	Highest Rank: 7
xổ số kon tum	Highest Rank: 6
xổ số long an	Highest Rank: 16
xổ số miền nam thứ bảy	Highest Rank: 19
xổ số miền nam thứ bảy hàng tuần	Highest Rank: 21
xổ số quảng ngãi	Highest Rank: 10
xổ số thứ bảy hàng tuần	Highest Rank: 13
ý đấu với pháp	Highest Rank: 11
đấu phá thương khung	Highest Rank: 14
đức đấu với bosnia và herzegovina	Highest Rank: 2
ตรวจ หวย 16 พ ย 67	Highest Rank: 9
ตรวจ หวย 16 พฤศจิกายน 2567	Highest Rank: 1
ตรวจ หวย 16 พฤศจิกายน 67	Highest Rank: 8
ตรวจ หวย รัฐบาล	Highest Rank: 17
ผล สลาก	Highest Rank: 22
ผล สลาก 16 11 67	Highest Rank: 15
ผล สลากกินแบ่ง รัฐบาล	Highest Rank: 18
ลอตเตอรี่	Highest Rank: 24
ลอตเตอรี่ 16 พฤศจิกายน 2567	Highest Rank: 7
สลากกินแบ่ง รัฐบาล	Highest Rank: 20
สลากกินแบ่ง รัฐบาล 16 พฤศจิกายน 2566	Highest Rank: 25
สลากกินแบ่ง รัฐบาล 16 พฤศจิกายน 2567	Highest Rank: 4
หวย 16 พฤศจิกายน 2567	Highest Rank: 3
alan jones	Highest Rank: 1
jones vs miocic	Highest Rank: 16
molly meldrum	Highest Rank: 11
nuclear weapons	Highest Rank: 22
sydney thomas	Highest Rank: 15
ufc 309 results	Highest Rank: 14
ufc309	Highest Rank: 23
wallabies vs wales	Highest Rank: 10
result 4d	Highest Rank: 23
toto	Highest Rank: 18
toto 4d	Highest Rank: 10
toto result	Highest Rank: 22
iñigo errejon	Highest Rank: 15
jorge martín	Highest Rank: 7
julio alberto	Highest Rank: 5
liga 123	Highest Rank: 14
liga hypermotion	Highest Rank: 23
moto gp hoy	Highest Rank: 13
real madrid c. f. femenino barcelona	Highest Rank: 1
real oviedo	Highest Rank: 21
real oviedo tenerife	Highest Rank: 8
real zaragoza málaga	Highest Rank: 4
resultados segunda división	Highest Rank: 22
segunda division	Highest Rank: 20
segunda división	Highest Rank: 12
sevilla atlético madrid	Highest Rank: 24
sporting gijón granada	Highest Rank: 2
live tv	Highest Rank: 25
liveball	Highest Rank: 22
албанія – чехія	Highest Rank: 10
волиньобленерго	Highest Rank: 17
график отключения света	Highest Rank: 11
อังกฤษ พบ ไอร์แลนด์	Highest Rank: 19
ไทย พบ ลาว	Highest Rank: 5
графік відключення світла	Highest Rank: 8
грузия – украина	Highest Rank: 2
грузія – україна	Highest Rank: 1
день студента	Highest Rank: 23
детек	Highest Rank: 15
добротвір	Highest Rank: 16
дтек	Highest Rank: 13
дтэк	Highest Rank: 12
збірна україни з футболу	Highest Rank: 24
ззовні 3 сезон	Highest Rank: 21
ліга націй	Highest Rank: 20
майк тайсон джейк пол кто победил	Highest Rank: 19
обленерго	Highest Rank: 18
светлана светличная	Highest Rank: 6
светличная	Highest Rank: 3
ту 160	Highest Rank: 9
украина грузия футбол	Highest Rank: 14
україна грузія	Highest Rank: 7
циркон	Highest Rank: 4
england rugby	Highest Rank: 25
england south africa rugby	Highest Rank: 18
gk barry	Highest Rank: 17
harwood bellis	Highest Rank: 6
im a celeb	Highest Rank: 23
jon kenny	Highest Rank: 4
met office weather forecast snow	Highest Rank: 13
moonflower murders	Highest Rank: 9
pillbox hat	Highest Rank: 16
rugby today	Highest Rank: 10
sarah hadland	Highest Rank: 5
snow warning	Highest Rank: 3
strictly come dancing	Highest Rank: 20
strictly spoiler	Highest Rank: 2
strictly voting	Highest Rank: 8
taylor harwood-bellis	Highest Rank: 22
tulisa	Highest Rank: 10
wales vs australia	Highest Rank: 4
who won jake paul or mike tyson	Highest Rank: 19
who won tyson vs paul	Highest Rank: 21
weather tomorrow	Highest Rank: 17
погода завтра	Highest Rank: 15
גבעות בר	Highest Rank: 3
הכוכב הבא	Highest Rank: 18
חמינאי	Highest Rank: 1
יציאת שבת	Highest Rank: 6
ירושמיים	Highest Rank: 24
ישראל בלגיה	Highest Rank: 2
ישראל נגד בלגיה	Highest Rank: 4
לוטו	Highest Rank: 13
מזג אוויר תל אביב	Highest Rank: 21
מזג אויר	Highest Rank: 25
מזג האוויר	Highest Rank: 19
מכם גשם	Highest Rank: 8
מתי יוצא שבת	Highest Rank: 10
עדנה גורן	Highest Rank: 5
פרגולות אלומיניום מומלצות סילברגייט פתרונות אלומיניום	Highest Rank: 12
צאת שבת	Highest Rank: 7
תחזית	Highest Rank: 20
תחזית מזג האוויר	Highest Rank: 16
תחזית מזג האוויר למחר	Highest Rank: 14
الطقس	Highest Rank: 23
الطقس غدًا	Highest Rank: 22
all blacks vs france	Highest Rank: 19
austria vs slovenia	Highest Rank: 21
cheslin kolbe	Highest Rank: 20
chiefs	Highest Rank: 23
england vs south africa	Highest Rank: 5
guinea vs dr congo	Highest Rank: 6
home of legends cup	Highest Rank: 11
kaizer chiefs vs golden arrows	Highest Rank: 3
kaizer chiefs vs mamelodi sundowns	Highest Rank: 7
new zealand vs france	Highest Rank: 2
norway vs kazakhstan	Highest Rank: 17
sa vs england	Highest Rank: 15
sa vs england rugby	Highest Rank: 14
springboks	Highest Rank: 22
springboks vs england	Highest Rank: 16
who won the tyson fight	Highest Rank: 13
france vs new zealand	Highest Rank: 3
guild meaning	Highest Rank: 13
jake paul vs mike tyson card	Highest Rank: 20
mike tyson net worth	Highest Rank: 22
actor arturo garcía tenorio	Highest Rank: 5
cecilia bolocco	Highest Rank: 22
cecilia bolocco miss universo	Highest Rank: 16
chilevision	Highest Rank: 23
chilevision en vivo	Highest Rank: 18
chv	Highest Rank: 21
chv en vivo	Highest Rank: 17
lele pons	Highest Rank: 12
macau	Highest Rank: 8
miss dinamarca 2024	Highest Rank: 4
miss universo 2024 en vivo	Highest Rank: 14
miss universo 2024 ganadora	Highest Rank: 6
nico ruiz	Highest Rank: 25
quien gano mike tyson o logan paul	Highest Rank: 3
quien gano miss universo 2024	Highest Rank: 7
recetas chilenas	Highest Rank: 1
south africa vs england	Highest Rank: 10
ufc 309 nz time	Highest Rank: 25
vip box	Highest Rank: 18
vipbox	Highest Rank: 11
vipleague	Highest Rank: 21
atle grønn	Highest Rank: 11
cengiz al	Highest Rank: 12
emilie nereng	Highest Rank: 20
heidi ruud ellingsen	Highest Rank: 21
